16|16|
1011111111111111
1010000110000001
1001010000101001
1010001101101111
1011101000101001
1000001000100101
1011111000111101
1000000000000001
1000000000000001
1000000000000001
1000000000000001
1000000000000001
1000000000000001
1000000000000001
1000000000000000
1111111111111111